8 8
= = = = = = = = 
= . . . . . . = 
= . . . . . . = 
= . . P $ . . = 
room2.door . . . . . . = 
= . . . . . . = 
= . . . . . . = 
= = = = = = = = 
