8 8
= = = = = = = = 
= . . . . . . = 
= . . . . . . = 
= . . . P . . = 
= . . . . . . room3.door 
= . . . . . . = 
= . . . . . . = 
= = = = = = = = 
