8 8
= = = = = = = =
= . . . . . . =
= . . . . . . =
= . . $ $ . . =
room2.door . . $ $ . . =
= . . . . . . =
= . . . . . . =
= = = = = = = =
